1111111111111111111
10P11010101C1C1C1C1
1101111111101010101
1000000000000000001
1E11111111111111111
1111111111111111111