11111111111111111111
10010001010110000E11
1CCCC100000000000011
11111P11111111111011
11100000000000010011
10000000000000011011
11111111111110000001
11111111111111111111