111111
100001
1PCCC1
100001
1ECCC1
111111