1111111
1000001
1111110
1111110
1111111
1EPC111
1111111