1111111
1000001
0111111
0111111
1111111
1EPC111
1111111