11111111
100P0011
10E11111
1C021341
1102CCC1
11111111