1100111
1000001
1100111
1100111
1100111
1EPC111
1111111