1111111111
1P111CE01
1000001
100001
10001		
1001
101
11
1